מביך, מביכה- embarrassing
תסרית - script (tas'rit)
מאמץ - effort
מפיק, מפיקה - producer (mefik, mefikah)
פסקול - soundtrack
גלריה - Gallery
אפקטים חמיוחדים - special effects
קהל - audience
איור - illustration 
מכחול - paintbrush (mik'khol) 
אוסף ציורים - painting collection 
צבעוני - colored
במה - stage
תיאטרון - theater (ti'atrhon) 
מרשים - impressive
מקומי - local (as in, "local theater") 
אמנות - art
צלמת, צלם - photographer
סטודיו, אולפן - studio
פסל - sculptor (pasal) 
הצגה - play (as in, "Shakespearean play") 
ריקוד - dance
מודרני - modern
אופנה - fashion
רקדן - dancer 
שירה - poetry
ספרות - literature
רקדנים - dancers
צילום - photography
דמות מטרט - character from a film
סגנונות, סגנון - style(s) 
פתעה - surprise
בודד - single
רגישה - sensitive
ביישן - shy 
דוחים - rejected (plural) 
חסר אונים - helpless 
מקדש - temple (mikdash) 
נצרות - Christianity
משיח - Messiah
יהדות - Judaism (iahadut) 
אסלאם - Islam
נשמה - soul
נוצרים - Christians (notsrim) 
בודהיסטים - Buddhist (plural) 
מוסלמים - Muslims (muslemim) 
פופולריות - popular (pl) 
דמעות - tears
רוחני - spiritual
מסגד - mosque (mis'gad) 
מלאך - angel 
כניסייה - church
תפילה - prayer
רתי, דתיה - religious
דת - religion
תשוקה - passion
הבדל - difference
אמונה - Faith (emuná) 
קשר - relationship
מרפאה - clinic (mirpa'ah) 
טיפול - treatment
לחץ - stress
לידה - birth 
בריאות - health
רפואה - medicine
הריונות - pregnancies 
סרטן - cancer
דיאטות, דיאטה - diets
לחץ דם - blood pressure 
חלומות, חלום - dreams, dream (khalom, khalomot) 
כף יד - palm of hand
פנים - face
מרפקים, מרפק- elbows (marpek) 
צוואר - neck
לבבות - hearts
זרוע - arm
אוזן - ear
סימן - sign
אילו - if (ihlu) 
אפשרויות - options
עוגה יום הולדת - birthday cake
מאושרת - happy
ברירה - choice
אישי - personal
דגר - fence
צעה - offer
הוגן - fair 
כעת - well... 
תפקיד - role
הרפתקה - adventure (harpatka) 
חיוך - smile (khiorr') 
הנאה - pleasure (hana'á) 
רצח - murder (retsakh) 
השלכות - consequences (hashalkhot) 
הפתעה - surprise (ha'phta'ah) 
צל - shade, shadow
חמוד - cute
מקור - source
ניסיון - experience
תועלת - benefit
עם כיוון השעון - clockwise
אופי - nature, character
התנהגות - behavior
רשות - permission
מציאות - nature
מאמץ - effort (ma'amets) 
סוד - secret
כיוון - direction
נזק - damage
הדם - blood
דמעה - tear 
אושר - happiness (o'sher) 
רגיש, רגישה - sensitive
בודד - lonely
מרתף - basement (mar'teph) 
רגועים, רגוע- calm (pl.) (rago'im) 
רגשות - feelings
הלם - shock
...חסר אונים, חברי אונים, חסרת- helpless
מבולבלת, מבולמלת - confused (mevul'bal, mevul'belet) 
דחיו, דחייום - rejected
עוינות, עוינת - hostile (o'inot) (plural) 
שובב, שובבה- mischievous (shovav) 
מופתע - surprised
פגוע - hurt
סביר - safe
ביישן - shy
בהכרח - necessarily (be'eh'kherkh) 
לאחרונה - recently
צודק, צודקת - right (while נכון is correct) 
אקדח - gun
כבוד - honor, respect
חכם - intelligent
הודעה - message
סמים, סם- drugs
בהחלט - strictly
סקס - sex
קו האוטובוס - bus line
משולש - slice, triangle
ריבוע - square (geometry) (ri'bua) 
מלבן - rectangle (mal'ben) 
צורה - shape (tsurrah) 
עיגול - circle
מעוין - rhombus
טרפז - trapezoid
מרובעים, מרובע - quadrilateral(s) (merrubah) 
קודקוד - vertex
אליפסה - ellipse
מקבילה, מקביל - equivalent, parallel
מקבילית - parallelogram 
זוויות, זווית - angles ((pl) zaviot, zavit) 
מחומש - pentagon (mekhumash) 
צלעות - edges
שושה - hexagon (shusheh) 
גאומטריה - geometry 
ההתנצלות - the apology (ha'hitnatslut) 
שמיעה - hearing
מכירה - sale
פתיחה - opening
רשמית - official
טריגונומטריה - trigonometry 
רוחב - width  (rokhav) 
נפח - volume (nephakh)
שטח - area (geometry) (shetakh) 
כפול - double 
עומק - depth (ohmek)
קופסה - box (kuphsah) 
אורך - length (ohrekh) 
אקדח - handgun
שמה - in that direction 
כיצד - how
סרגל - ruler
מידה - measurement
יחידת - unit
סנטימטר - centimeter
מילימטר - millimeter 
קילומטר - kilometer
תוכנת - plan
חתימה - signature, autograph (khatimá) 
עמדה - position (emm'dah) 
סופי - final
סמל - symbol (semel') 
אחריות - responsibility
מיידית - immediately
הומור - humor
סכנה - danger (sakaná) 
מסורת - tradition 
נפילה - fall
זיכרון - memory
זכרונות - memories
הפסד - loss
ניצחון - victory
נכסת - danger of
זהירות - caution
שקרים, שקר - lies, lie
נפילה חופשית - free fall
תשוקה - passion 
הבדל - difference
רחב - wide 
בסיס יומי - daily basis
תכונה - trait
בסיס - base
טובה - favor
חוש - sense
חזיר - pig
עדיפות - priority
עליונה - top (as in "top priority") 
חשיבות - importance
יופי - beauty
פרח - flower
גבולות - bounds, borders
זהות, זהויות - identity, identities
מזל - luck
גאה - proud
ציון - grade
כמוני - as me
בשקט - quiet 
תוכנית - plan
חבל - too bad, alas
חג המולד - Christmas
בתי מלאכה לעץ - wood workshops
פסקי זמן - timeouts
גבור - border (gvur) 
מגדלי שמירה - watchtowers
פניית פרסה - U-turn (p'niat parsah) 
שעון צער - stopwatch
תיבה דואר - mailbox
אוצר מילים - vocabulary
אוצר - treasure (otsar) 
מברשת שיניים - toothbrush (miv'rishet shinaim) 
סכין גילוח - shaving razor
ארגז הכלים - toolbox
משחת שיניים - toothpaste
ראש הממשלה - prime Minister
ממשלה - government
משום - because
מודרני - modern
מחרתיים - In two days time, two dais from now (mokhortaim) 
נמל - port (nemal) 
פגישה - meeting
יקירתי - my dear
שיער - hair
עור - skin
מוח - mind
לשון - tongue
כלא - jail
כרטיס - ticket
סקס - sex
מלחמה - war
כפות רגליים - feet
ברכיים, ברך - knees, knee
כתפיים, כתף - shoulders, shoulder (catef) 
שריר - muscle
גוף אדם - human body 
איברים, איבר- organs (ivahrim) 
מחלות, מחלה - diseases (mekhalah, makhalot)
גולגולת - skull (gulgolet) 
תרופה - medication
חולי לב - heart patients 
וירוס - virus
מטובלים, מטופל - patient(S) (metupelim) 
ניתוח - operation
מידע - information
חושש - afraid
רוצח - murderer
מערת מכפלה - cave of the patriarchs
נכסיית קבר - church of the holy sepulchre
הר זיתים - mount of olives
כפית סלע - dome of the rock
הר בית - temple mount
כותל מערבי - Western wall
קצר-רוח - impatient
טעם - taste
מגוחך - absurd, ridiculous, rubbish, ludicrous
גבול - border
הזדמנות - chance
בדיחה - joke
